4	4	4	4	4	4	4	4	4	4	4	4	4	4	4	5	5	4	4	4	4	4	4	4	4	4	4	4	4	4	4	4	4	4	4	4	4	4	4
4	0	0	0	0	0	0	0	4	0	0	4	0	0	0	0	0	0	0	0	4	0	0	0	0	0	4	0	0	4	0	0	0	0	0	0	0	0	4
4	0	0	0	0	0	0	0	4	0	0	4	0	0	0	0	0	0	0	1	4	0	0	0	0	0	4	0	0	4	0	0	0	0	0	0	0	0	4
4	0	0	0	0	4	0	0	4	0	0	4	0	0	0	0	0	0	0	0	4	0	0	0	0	0	4	0	0	4	0	0	4	4	4	4	0	0	4
4	0	0	0	0	4	0	0	4	0	0	4	0	0	0	0	0	0	0	1	4	0	0	0	0	0	4	0	0	4	0	0	4	0	0	0	0	0	4
4	4	4	4	4	4	0	0	4	0	0	4	0	0	4	4	4	4	4	4	4	0	0	4	0	0	4	0	0	4	0	0	4	0	0	0	0	0	4
4	0	0	0	0	4	0	0	4	0	0	4	0	0	0	0	0	0	0	0	0	0	0	4	0	0	4	0	0	4	3	0	4	0	0	0	0	0	4
4	0	0	0	0	4	0	0	4	0	0	4	0	0	0	0	0	0	0	0	0	0	0	4	0	0	4	0	0	4	4	4	4	4	4	4	0	0	4
4	0	0	0	0	0	0	0	4	0	0	4	0	0	0	0	0	0	0	0	0	0	0	4	0	0	4	0	0	0	0	0	0	0	0	4	0	0	4
4	0	0	0	0	0	0	2	4	0	0	4	0	0	0	0	0	0	0	0	0	0	0	4	0	0	4	0	0	0	0	0	0	0	0	4	0	0	4
4	0	0	4	4	4	4	4	4	0	0	4	4	4	4	4	4	4	4	4	4	4	4	4	0	0	4	4	4	4	4	4	4	0	0	4	0	0	4
4	0	0	0	0	0	0	0	0	0	0	4	0	0	0	0	0	0	0	0	0	0	0	0	0	0	0	0	0	0	0	1	4	0	0	4	0	0	4
4	0	0	0	0	0	0	0	0	0	1	4	0	0	0	0	0	0	0	0	0	0	0	0	0	0	0	0	0	0	0	0	4	0	0	4	0	0	4
4	4	4	4	4	4	4	4	4	0	0	4	0	0	0	0	0	4	4	4	4	4	4	4	4	4	4	4	4	4	0	0	4	0	0	4	0	0	4
4	0	0	0	0	0	0	0	4	0	0	4	0	0	4	0	0	0	0	0	0	0	0	0	0	0	0	0	0	0	0	0	0	0	0	4	0	0	4
4	0	0	0	0	0	0	1	4	0	0	4	0	0	4	0	0	0	0	0	0	0	0	0	0	0	0	0	0	0	0	0	0	0	2	4	0	0	4
4	0	0	0	4	0	0	0	4	0	0	4	0	0	4	4	4	4	4	4	4	4	4	4	4	4	4	4	4	4	4	4	4	4	4	4	0	0	4
4	0	0	0	4	0	0	0	4	0	0	4	0	0	4	0	0	0	0	0	0	0	0	0	0	0	4	0	0	0	4	0	0	0	0	0	0	0	4
4	0	0	0	4	0	0	0	4	0	0	4	0	0	4	0	0	0	0	0	0	0	0	0	0	0	4	0	0	0	4	0	0	0	0	0	0	0	4
4	0	0	0	4	0	0	0	4	0	0	4	0	0	0	0	0	0	0	0	0	0	0	0	0	0	4	0	0	0	4	0	0	0	0	0	0	0	4
4	0	0	0	4	0	0	0	4	0	0	4	0	0	0	0	0	0	0	0	0	0	0	1	0	0	4	0	0	0	4	0	0	0	0	0	0	0	4
4	0	0	0	4	0	0	0	4	0	0	4	4	4	4	0	0	4	4	4	4	4	4	4	0	0	4	0	0	0	4	0	0	0	0	0	0	0	4
4	0	0	0	4	0	0	0	4	0	0	0	0	0	4	0	0	0	0	0	0	0	0	4	0	0	4	0	0	0	0	0	0	0	0	0	0	0	4
4	0	0	0	4	0	0	0	4	0	0	0	0	0	4	0	0	0	0	0	0	0	0	4	0	0	4	0	0	0	0	0	0	0	0	0	0	0	4
4	0	0	0	4	0	0	4	4	0	0	4	0	0	4	0	0	4	4	4	4	0	0	4	0	0	4	4	4	4	4	4	4	4	4	4	0	0	4
4	0	0	0	4	0	0	0	0	0	0	4	0	0	4	0	0	0	0	0	0	0	0	4	0	0	0	0	0	0	0	4	0	0	0	0	0	0	4
4	0	0	0	4	0	0	0	0	0	0	4	0	0	4	0	0	0	0	0	0	0	0	4	0	0	0	0	0	0	0	4	0	0	0	0	0	0	4
4	0	0	0	4	4	4	4	4	4	4	4	4	4	4	4	4	4	4	4	4	0	0	4	0	0	4	4	4	4	4	4	4	4	4	4	0	0	4
4	0	0	0	0	0	0	0	0	0	0	0	0	0	0	0	0	0	0	0	4	0	0	4	0	0	0	0	0	0	0	4	0	0	0	0	0	0	4
4	0	0	0	0	0	0	0	0	0	0	0	0	0	0	0	0	0	0	0	4	0	0	4	0	0	0	0	0	0	0	4	0	0	0	0	0	0	4
4	0	0	0	0	0	0	0	4	0	0	0	0	0	0	0	0	0	0	0	0	0	0	0	0	0	0	0	0	0	0	0	0	0	0	1	0	0	4
4	0	0	0	0	0	0	0	4	0	0	0	0	0	0	0	0	0	0	0	0	0	0	0	0	0	0	0	0	0	0	0	0	0	0	1	0	0	4
4	4	4	4	4	4	4	4	4	4	4	4	4	4	4	4	4	4	4	4	4	4	4	4	4	4	4	4	4	6	6	4	4	4	4	4	4	4	4
